LABIRINTO 10 10
1 1 1 1 1 1 1 1 1 1 
1 0 0 0 0 0 0 0 0 1 
1 0 1 1 1 1 1 1 0 1 
1 0 1 1 1 1 1 1 0 1 
1 0 1 1 1 1 1 1 0 1 
1 0 1 1 1 1 1 1 0 1 
1 0 1 1 1 1 1 1 0 1 
1 0 1 1 1 1 1 1 0 1 
1 0 1 1 1 1 1 1 0 1 
1 1 1 1 1 1 1 1 1 1
QUESTÃO 10
Origem: 9 0
Destino: 0 9

